{
  "rooms": [
    {
      "id": "start",
      "tiles": [
        "########",
        "#......#",
        "#..H...#",
        "#......#",
        "#..F...#",
        "#......#",
        "#......#",
        "########"
      ]
    },
    {
      "id": "power",
      "tiles": [
        "########",
        "#..C...#",
        "#......#",
        "#..H...#",
        "#......#",
        "#...F..#",
        "#......#",
        "########"
      ]
    },
    {
      "id": "loot",
      "tiles": [
        "########",
        "#..L...#",
        "#..L...#",
        "#......#",
        "#..H...#",
        "#......#",
        "#......#",
        "########"
      ]
    },
    {
      "id": "standard",
      "tiles": [
        "########",
        "#......#",
        "#..H...#",
        "#......#",
        "#...F..#",
        "#......#",
        "#......#",
        "########"
      ]
    },
    {
      "id": "extraction",
      "tiles": [
        "########",
        "#......#",
        "#..E...#",
        "#......#",
        "#..F...#",
        "#......#",
        "#......#",
        "########"
      ]
    }
  ]
}
